#################################
#...............................#
#.#.#.#.#.#.#.#.#.#.#.#.#.#.#.#.#
#...............................#
#.#.#.#.#.#.#.#.#.#.#.#.#.#.#.#.#
#...............................#
#.#.#.#.#.#.#.#.#.#.#.#.#.#.#.#.#
#...............................#
#.#.#.#.#.#.#.#.#.#.#.#.#.#.#.#.#
#...............................#
#.#.#.#.#.#.#.#.#.#.#.#.#.#.#.#.#
#...............................#
#################################